SO ./image_xpm/medved.xpm
NO ./image_xpm/felix.xpm
WE ./image_xpm/bust.xpm
EA ./image_xpm/12.xpm


C 60, 72, 112

F 84, 118, 152



    11111111111    1111111111111111111111111111111111111111111  1
111111100000001    1000000011100000000000000100000000000000111  11111
   111100000001    10000000111000000000000001000000000000000111  11
   111100000001    1000000011100000000000000100000000000000111  11
111111100000001    1000000011100000000000000000000000000000111  11
111111100000001    1000000011100000000000000100000000000000111  11
111111100000001    1000000011100000000000000100000000000000111  11
111111100000001    10000000111000000000000001000000000000001111111
111111100000001    100000001111000000000000011111111111111111111111
1     100000001111110000000000000000000000001000000000000001000001
1     100000000000000000000000000000000000000000000000000001000001
1     100000000000000000000000000000000000000000000000000001000001
1     100000000000000000000000000000000000000000000000000001000001
1     10000000000000000001000000000000000000000000000000001100001
1     100000000000000000000W110000000000001000000000000001000001
1     111111111111111111111111111111111111111111111111111111111111
1          1                        1
111111111111                      111
100000000001               111111111111111111111111111111
100000000001                        1
1111111111111111111111111111111111111