SO ./image_xpm/medved.xpm
NO ./image_xpm/felix.xpm
WE ./image_xpm/bust.xpm
EA ./image_xpm/12.xpm

F 203, 192, 152

C 209,183,255


        1111111111111111111111111
        1000000000110000000010001
        1011000001110000000101001
        100100000000000000001000111
111111111011000001110000000000001
10000000001100000111011111111111111
11111111111111111111111
11111111111111111111111111111111
11110111111111011100000010001011
111101111111110111010100000011111
1100000011010101110000001000111011
100000000000000011000000100011111
100000000000000011010100100011
11000001110101011111011100N00111
11110111 111010101 111100000111
11111111 111111111 11111111111
  